,id,condition,chunk,bl,tr,ts,delta_c
0,9,fast,high2,10,107,31,21
1,9,fast,medium2,48,172,62,14
2,9,fast,sz3,10,135,39,29
3,9,fast,sz4,3,76,20,17
4,45,fast,high2,8,186,28,20
5,45,fast,medium2,6,168,14,8
6,45,fast,sz3,5,249,15,10
7,45,fast,sz4,1,175,4,3
8,69,fast,high2,47,154,65,18
9,69,fast,medium2,54,185,63,9
10,69,fast,sz3,57,218,91,34
11,69,fast,sz4,34,150,68,34
12,82,fast,high2,14,62,39,25
13,82,fast,medium2,16,55,42,26
14,82,fast,sz3,7,37,43,36
15,82,fast,sz4,2,18,23,21
16,83,fast,high2,50,189,62,12
17,83,fast,medium2,35,166,48,13
18,83,fast,sz3,44,244,65,21
19,83,fast,sz4,24,164,41,17
20,85,fast,high2,20,154,64,44
21,85,fast,medium2,6,94,54,48
22,85,fast,sz3,5,113,74,69
23,85,fast,sz4,1,55,50,49
24,88,fast,high2,11,154,59,48
25,88,fast,medium2,5,110,48,43
26,88,fast,sz3,3,140,64,61
27,88,fast,sz4,0,81,36,36
28,97,fast,high2,57,175,71,14
29,97,fast,medium2,41,118,51,10
30,97,fast,sz3,61,170,84,23
31,97,fast,sz4,43,102,62,19
32,99,fast,high2,8,81,44,36
33,99,fast,medium2,41,154,56,15
34,99,fast,sz3,10,115,63,53
35,99,fast,sz4,4,73,42,38
36,100,fast,high2,34,139,53,19
37,100,fast,medium2,30,99,39,9
38,100,fast,sz3,24,123,54,30
39,100,fast,sz4,10,58,34,24
40,107,fast,high2,56,186,72,16
41,107,fast,medium2,19,105,52,33
42,107,fast,sz3,31,163,77,46
43,107,fast,sz4,18,106,49,31
44,109,fast,high2,12,118,40,28
45,109,fast,medium2,29,144,50,21
46,109,fast,sz3,11,136,53,42
47,109,fast,sz4,4,70,36,32
48,111,fast,high2,12,76,47,35
49,111,fast,medium2,46,151,49,3
50,111,fast,sz3,13,87,53,40
51,111,fast,sz4,3,50,30,27
52,116,fast,high2,19,134,63,44
53,116,fast,medium2,1,20,35,34
54,116,fast,sz3,1,27,47,46
55,116,fast,sz4,0,13,27,27
56,118,fast,high2,32,91,45,13
57,118,fast,medium2,24,64,41,17
58,118,fast,sz3,26,52,49,23
59,118,fast,sz4,10,14,29,19
60,119,fast,high2,23,175,66,43
61,119,fast,medium2,11,132,49,38
62,119,fast,sz3,10,184,70,60
63,119,fast,sz4,6,112,45,39
64,120,fast,high2,47,180,64,17
65,120,fast,medium2,49,159,58,9
66,120,fast,sz3,57,217,80,23
67,120,fast,sz4,39,151,56,17
68,122,fast,high2,38,132,51,13
69,122,fast,medium2,28,125,53,25
70,122,fast,sz3,28,157,68,40
71,122,fast,sz4,16,111,48,32
72,123,fast,high2,28,125,64,36
73,123,fast,medium2,26,95,61,35
74,123,fast,sz3,25,101,87,62
75,123,fast,sz4,13,48,60,47
76,124,fast,high2,54,150,43,-11
77,124,fast,medium2,50,131,44,-6
78,124,fast,sz3,76,167,49,-27
79,124,fast,sz4,60,108,28,-32
80,125,fast,high2,7,111,45,38
81,125,fast,medium2,4,70,35,31
82,125,fast,sz3,0,77,39,39
83,125,fast,sz4,0,28,21,21
84,126,fast,high2,41,145,50,9
85,126,fast,medium2,9,48,31,22
86,126,fast,sz3,7,57,31,24
87,126,fast,sz4,1,19,11,10
88,128,fast,high2,41,179,63,22
89,128,fast,medium2,32,160,56,24
90,128,fast,sz3,36,227,83,47
91,128,fast,sz4,22,160,58,36
92,132,fast,high2,3,159,70,67
93,132,fast,medium2,4,118,57,53
94,132,fast,sz3,0,168,94,94
95,132,fast,sz4,0,118,65,65
96,134,fast,high2,7,60,32,25
97,134,fast,medium2,35,169,64,29
98,134,fast,sz3,9,83,47,38
99,134,fast,sz4,3,48,25,22
100,135,fast,high2,35,142,59,24
101,135,fast,medium2,19,120,47,28
102,135,fast,sz3,23,163,64,41
103,135,fast,sz4,15,109,39,24
104,136,fast,high2,47,176,70,23
105,136,fast,medium2,23,90,59,36
106,136,fast,sz3,31,118,91,60
107,136,fast,sz4,18,60,66,48
108,137,fast,high2,30,159,59,29
109,137,fast,medium2,13,95,35,22
110,137,fast,sz3,15,123,52,37
111,137,fast,sz4,7,69,26,19
112,139,fast,high2,37,172,56,19
113,139,fast,medium2,33,130,42,9
114,139,fast,sz3,43,205,64,21
115,139,fast,sz4,29,157,47,18
116,150,fast,high2,0,82,17,17
117,150,fast,medium2,0,61,11,11
118,150,fast,sz3,0,77,12,12
119,150,fast,sz4,0,45,7,7
120,153,fast,high2,48,136,54,6
121,153,fast,medium2,50,112,37,-13
122,153,fast,sz3,64,126,52,-12
123,153,fast,sz4,42,68,33,-9
124,159,fast,high2,37,114,45,8
125,159,fast,medium2,63,152,55,-8
126,159,fast,sz3,59,161,62,3
127,159,fast,sz4,40,102,43,3
128,165,fast,high2,52,200,73,21
129,165,fast,medium2,22,160,61,39
130,165,fast,sz3,28,250,96,68
131,165,fast,sz4,12,179,73,61
132,179,fast,high2,56,141,46,-10
133,179,fast,medium2,40,91,40,0
134,179,fast,sz3,53,111,42,-11
135,179,fast,sz4,25,70,23,-2
136,181,fast,high2,28,117,43,15
137,181,fast,medium2,25,155,58,33
138,181,fast,sz3,25,148,58,33
139,181,fast,sz4,13,87,39,26
140,182,fast,high2,11,128,59,48
141,182,fast,medium2,11,128,58,47
142,182,fast,sz3,6,163,80,74
143,182,fast,sz4,1,117,57,56
144,187,fast,high2,43,137,47,4
145,187,fast,medium2,58,168,54,-4
146,187,fast,sz3,60,185,60,0
147,187,fast,sz4,32,99,31,-1
148,188,fast,high2,53,136,40,-13
149,188,fast,medium2,52,128,47,-5
150,188,fast,sz3,66,144,44,-22
151,188,fast,sz4,39,83,22,-17
152,193,fast,high2,35,183,66,31
153,193,fast,medium2,18,117,45,27
154,193,fast,sz3,26,166,60,34
155,193,fast,sz4,16,102,32,16
156,198,fast,high2,51,137,38,-13
157,198,fast,medium2,48,73,13,-35
158,198,fast,sz3,58,103,14,-44
159,198,fast,sz4,40,60,5,-35
160,199,fast,high2,43,166,26,-17
161,199,fast,medium2,47,132,18,-29
162,199,fast,sz3,45,174,14,-31
163,199,fast,sz4,20,107,4,-16
164,201,fast,high2,2,26,4,2
165,201,fast,medium2,0,0,0,0
166,201,fast,sz3,0,0,0,0
167,201,fast,sz4,0,0,0,0
168,207,fast,high2,58,187,63,5
169,207,fast,medium2,24,159,51,27
170,207,fast,sz3,40,213,76,36
171,207,fast,sz4,26,145,54,28
172,208,fast,high2,3,55,13,10
173,208,fast,medium2,0,28,4,4
174,208,fast,sz3,0,25,3,3
175,208,fast,sz4,0,11,1,1
176,211,fast,high2,17,70,20,3
177,211,fast,medium2,27,128,50,23
178,211,fast,sz3,15,85,30,15
179,211,fast,sz4,7,51,15,8
180,212,fast,high2,52,202,72,20
181,212,fast,medium2,20,143,51,31
182,212,fast,sz3,31,226,84,53
183,212,fast,sz4,17,164,65,48
184,228,fast,high2,40,175,67,27
185,228,fast,medium2,20,118,39,19
186,228,fast,sz3,26,173,58,32
187,228,fast,sz4,15,121,39,24
188,229,fast,high2,34,183,70,36
189,229,fast,medium2,0,37,44,44
190,229,fast,sz3,0,60,65,65
191,229,fast,sz4,0,32,42,42
192,233,fast,high2,0,115,2,2
193,233,fast,medium2,0,74,2,2
194,233,fast,sz3,0,120,0,0
195,233,fast,sz4,0,91,0,0
196,234,fast,high2,46,142,50,4
197,234,fast,medium2,21,111,40,19
198,234,fast,sz3,25,149,46,21
199,234,fast,sz4,11,98,29,18
200,240,fast,high2,21,168,59,38
201,240,fast,medium2,28,181,53,25
202,240,fast,sz3,22,236,77,55
203,240,fast,sz4,13,162,58,45
204,241,fast,high2,0,63,1,1
205,241,fast,medium2,0,60,2,2
206,241,fast,sz3,0,66,0,0
207,241,fast,sz4,0,34,0,0
208,243,fast,high2,44,142,57,13
209,243,fast,medium2,34,106,47,13
210,243,fast,sz3,41,133,62,21
211,243,fast,sz4,21,78,40,19
212,246,fast,high2,23,132,53,30
213,246,fast,medium2,33,107,56,23
214,246,fast,sz3,20,111,65,45
215,246,fast,sz4,5,58,41,36
216,4,accurate,high2,62,133,70,8
217,4,accurate,medium2,35,109,60,25
218,4,accurate,sz3,55,125,91,36
219,4,accurate,sz4,37,70,66,29
220,22,accurate,high2,45,182,76,31
221,22,accurate,medium2,27,152,64,37
222,22,accurate,sz3,35,214,102,67
223,22,accurate,sz4,18,143,73,55
224,28,accurate,high2,4,8,1,-3
225,28,accurate,medium2,7,7,2,-5
226,28,accurate,sz3,5,0,0,-5
227,28,accurate,sz4,3,0,0,-3
228,30,accurate,high2,61,169,57,-4
229,30,accurate,medium2,36,144,37,1
230,30,accurate,sz3,46,177,52,6
231,30,accurate,sz4,27,107,28,1
232,40,accurate,high2,23,72,51,28
233,40,accurate,medium2,21,60,26,5
234,40,accurate,sz3,9,36,25,16
235,40,accurate,sz4,1,9,9,8
236,44,accurate,high2,53,159,55,2
237,44,accurate,medium2,56,181,62,6
238,44,accurate,sz3,67,216,80,13
239,44,accurate,sz4,40,133,57,17
240,52,accurate,high2,54,104,70,16
241,52,accurate,medium2,52,61,62,10
242,52,accurate,sz3,65,72,92,27
243,52,accurate,sz4,40,38,66,26
244,56,accurate,high2,17,143,55,38
245,56,accurate,medium2,19,106,50,31
246,56,accurate,sz3,10,112,63,53
247,56,accurate,sz4,2,44,38,36
248,62,accurate,high2,5,6,18,13
249,62,accurate,medium2,5,12,3,-2
250,62,accurate,sz3,0,1,2,2
251,62,accurate,sz4,0,0,0,0
252,66,accurate,high2,44,119,45,1
253,66,accurate,medium2,19,59,28,9
254,66,accurate,sz3,23,64,33,10
255,66,accurate,sz4,17,38,13,-4
256,81,accurate,high2,50,136,49,-1
257,81,accurate,medium2,37,145,49,12
258,81,accurate,sz3,41,141,58,17
259,81,accurate,sz4,23,77,37,14
260,102,accurate,high2,7,24,12,5
261,102,accurate,medium2,14,51,30,16
262,102,accurate,sz3,1,13,14,13
263,102,accurate,sz4,0,3,8,8
264,104,accurate,high2,41,206,61,20
265,104,accurate,medium2,10,107,27,17
266,104,accurate,sz3,18,177,44,26
267,104,accurate,sz4,11,102,29,18
268,105,accurate,high2,43,165,58,15
269,105,accurate,medium2,33,139,64,31
270,105,accurate,sz3,40,180,90,50
271,105,accurate,sz4,22,114,66,44
272,106,accurate,high2,36,159,66,30
273,106,accurate,medium2,35,118,60,25
274,106,accurate,sz3,31,156,85,54
275,106,accurate,sz4,11,103,60,49
276,108,accurate,high2,61,172,66,5
277,108,accurate,medium2,54,140,50,-4
278,108,accurate,sz3,87,209,77,-10
279,108,accurate,sz4,69,144,53,-16
280,110,accurate,high2,46,203,73,27
281,110,accurate,medium2,42,179,54,12
282,110,accurate,sz3,61,275,88,27
283,110,accurate,sz4,45,200,67,22
284,113,accurate,high2,50,153,66,16
285,113,accurate,medium2,13,54,17,4
286,113,accurate,sz3,15,61,26,11
287,113,accurate,sz4,4,27,11,7
288,117,accurate,high2,14,88,35,21
289,117,accurate,medium2,7,41,14,7
290,117,accurate,sz3,5,34,12,7
291,117,accurate,sz4,1,7,2,1
292,121,accurate,high2,16,102,82,66
293,121,accurate,medium2,19,79,60,41
294,121,accurate,sz3,21,96,101,80
295,121,accurate,sz4,14,65,78,64
296,127,accurate,high2,37,106,37,0
297,127,accurate,medium2,46,52,40,-6
298,127,accurate,sz3,49,61,40,-9
299,127,accurate,sz4,31,25,18,-13
300,130,accurate,high2,7,100,48,41
301,130,accurate,medium2,19,143,53,34
302,130,accurate,sz3,11,116,59,48
303,130,accurate,sz4,7,61,30,23
304,131,accurate,high2,48,133,49,1
305,131,accurate,medium2,50,162,44,-6
306,131,accurate,sz3,46,174,54,8
307,131,accurate,sz4,18,105,35,17
308,133,accurate,high2,36,162,63,27
309,133,accurate,medium2,51,166,60,9
310,133,accurate,sz3,48,200,85,37
311,133,accurate,sz4,30,127,62,32
312,138,accurate,high2,46,105,45,-1
313,138,accurate,medium2,33,93,29,-4
314,138,accurate,sz3,31,79,33,2
315,138,accurate,sz4,11,27,15,4
316,140,accurate,high2,6,86,56,50
317,140,accurate,medium2,3,57,38,35
318,140,accurate,sz3,2,42,47,45
319,140,accurate,sz4,0,11,22,22
320,141,accurate,high2,12,115,54,42
321,141,accurate,medium2,0,40,38,38
322,141,accurate,sz3,0,46,49,49
323,141,accurate,sz4,0,21,35,35
324,144,accurate,high2,17,151,59,42
325,144,accurate,medium2,16,124,47,31
326,144,accurate,sz3,13,169,64,51
327,144,accurate,sz4,5,113,43,38
328,145,accurate,high2,30,116,47,17
329,145,accurate,medium2,31,122,57,26
330,145,accurate,sz3,25,125,68,43
331,145,accurate,sz4,9,72,46,37
332,146,accurate,high2,25,146,57,32
333,146,accurate,medium2,0,97,40,40
334,146,accurate,sz3,0,130,55,55
335,146,accurate,sz4,0,80,34,34
336,147,accurate,high2,30,105,40,10
337,147,accurate,medium2,52,147,41,-11
338,147,accurate,sz3,40,133,50,10
339,147,accurate,sz4,22,76,31,9
340,149,accurate,high2,61,190,51,-10
341,149,accurate,medium2,52,185,58,6
342,149,accurate,sz3,72,254,64,-8
343,149,accurate,sz4,45,167,36,-9
344,155,accurate,high2,10,39,57,47
345,155,accurate,medium2,5,8,29,24
346,155,accurate,sz3,1,1,41,40
347,155,accurate,sz4,0,0,25,25
348,156,accurate,high2,62,189,47,-15
349,156,accurate,medium2,55,186,49,-6
350,156,accurate,sz3,75,264,51,-24
351,156,accurate,sz4,48,191,25,-23
352,157,accurate,high2,42,122,61,19
353,157,accurate,medium2,52,154,57,5
354,157,accurate,sz3,52,166,83,31
355,157,accurate,sz4,30,109,63,33
356,164,accurate,high2,7,62,56,49
357,164,accurate,medium2,14,86,44,30
358,164,accurate,sz3,1,53,58,57
359,164,accurate,sz4,0,21,32,32
360,171,accurate,high2,65,162,56,-9
361,171,accurate,medium2,56,138,50,-6
362,171,accurate,sz3,86,172,71,-15
363,171,accurate,sz4,60,106,47,-13
364,174,accurate,high2,44,97,45,1
365,174,accurate,medium2,52,113,35,-17
366,174,accurate,sz3,57,85,36,-21
367,174,accurate,sz4,34,28,13,-21
368,175,accurate,high2,14,91,55,41
369,175,accurate,medium2,24,99,48,24
370,175,accurate,sz3,11,93,63,52
371,175,accurate,sz4,2,51,44,42
372,176,accurate,high2,21,146,50,29
373,176,accurate,medium2,8,98,26,18
374,176,accurate,sz3,3,115,26,23
375,176,accurate,sz4,1,56,10,9
376,178,accurate,high2,43,150,65,22
377,178,accurate,medium2,24,68,45,21
378,178,accurate,sz3,30,87,68,38
379,178,accurate,sz4,14,39,48,34
380,185,accurate,high2,41,148,46,5
381,185,accurate,medium2,30,113,56,26
382,185,accurate,sz3,36,136,56,20
383,185,accurate,sz4,18,77,29,11
384,204,accurate,high2,47,175,55,8
385,204,accurate,medium2,50,114,44,-6
386,204,accurate,sz3,55,155,53,-2
387,204,accurate,sz4,31,93,34,3
388,205,accurate,high2,55,190,72,17
389,205,accurate,medium2,28,98,60,32
390,205,accurate,sz3,43,154,95,52
391,205,accurate,sz4,27,93,71,44
392,209,accurate,high2,39,138,59,20
393,209,accurate,medium2,37,127,53,16
394,209,accurate,sz3,45,151,81,36
395,209,accurate,sz4,30,91,56,26
396,210,accurate,high2,2,1,2,0
397,210,accurate,medium2,5,1,6,1
398,210,accurate,sz3,2,0,0,-2
399,210,accurate,sz4,0,0,0,0
400,213,accurate,high2,0,0,24,24
401,213,accurate,medium2,0,0,0,0
402,213,accurate,sz3,0,0,0,0
403,213,accurate,sz4,0,0,0,0
404,214,accurate,high2,52,162,61,9
405,214,accurate,medium2,49,123,66,17
406,214,accurate,sz3,66,154,91,25
407,214,accurate,sz4,47,81,65,18
408,215,accurate,high2,48,174,67,19
409,215,accurate,medium2,45,144,61,16
410,215,accurate,sz3,50,183,88,38
411,215,accurate,sz4,27,118,63,36
412,217,accurate,high2,33,136,70,37
413,217,accurate,medium2,39,140,68,29
414,217,accurate,sz3,36,149,105,69
415,217,accurate,sz4,17,93,81,64
416,218,accurate,high2,67,212,70,3
417,218,accurate,medium2,58,179,69,11
418,218,accurate,sz3,91,283,102,11
419,218,accurate,sz4,66,213,77,11
420,219,accurate,high2,27,119,66,39
421,219,accurate,medium2,16,65,62,46
422,219,accurate,sz3,23,67,86,63
423,219,accurate,sz4,15,32,60,45
424,221,accurate,high2,49,185,69,20
425,221,accurate,medium2,48,134,54,6
426,221,accurate,sz3,66,199,87,21
427,221,accurate,sz4,49,129,63,14
428,223,accurate,high2,3,12,1,-2
429,223,accurate,medium2,4,21,0,-4
430,223,accurate,sz3,0,9,0,0
431,223,accurate,sz4,0,3,0,0
432,224,accurate,high2,22,157,49,27
433,224,accurate,medium2,18,82,39,21
434,224,accurate,sz3,6,100,39,33
435,224,accurate,sz4,2,47,16,14
436,225,accurate,high2,65,144,68,3
437,225,accurate,medium2,54,123,58,4
438,225,accurate,sz3,82,141,85,3
439,225,accurate,sz4,56,77,58,2
440,226,accurate,high2,61,171,74,13
441,226,accurate,medium2,43,89,51,8
442,226,accurate,sz3,64,119,86,22
443,226,accurate,sz4,42,69,63,21
444,231,accurate,high2,46,119,64,18
445,231,accurate,medium2,44,122,54,10
446,231,accurate,sz3,53,119,79,26
447,231,accurate,sz4,33,67,53,20
448,236,accurate,high2,61,165,66,5
449,236,accurate,medium2,48,55,35,-13
450,236,accurate,sz3,72,88,56,-16
451,236,accurate,sz4,49,51,30,-19
452,237,accurate,high2,9,77,24,15
453,237,accurate,medium2,42,157,45,3
454,237,accurate,sz3,12,97,21,9
455,237,accurate,sz4,5,61,8,3
456,242,accurate,high2,2,61,58,56
457,242,accurate,medium2,2,22,38,36
458,242,accurate,sz3,0,29,45,45
459,242,accurate,sz4,0,16,27,27
460,244,accurate,high2,58,158,67,9
461,244,accurate,medium2,31,105,40,9
462,244,accurate,sz3,43,134,63,20
463,244,accurate,sz4,22,69,41,19
